clientアプリ|clientアプリ|around
se|sequenceDiagram|around
iFLOWER|iFLOWER|around
seq|sequenceDiagram|around
mermaid|mermaid|around
sapi|sapi|around
iFlower|iFlowerにて、オークションで取り扱う商品が上場される|around
u|Using|around
|"ordered"|json
false|false|json
mark|markdownlint|around
reque|requirements|around
|swagger.yaml|file
備考情報取得API|備考情報一括取得API|around
cli|cliv2|around
api|api_framework|around
sh|share|around
install|installer|around
local|local|around
task|task|around
|main|file
Command|CocCommand|around
iFlower|iFlowerによる販売用語|around
May|May|around
Wed|Wednesday|around
distribution|distribution|around
true|true|json
aucnet|aucnet|around
docs|docs|around
ad|addEventListener|tsserver-javascript
df|detailField|around
dfd|detailField|around
plugin|plugins|around
s|s|css
coc|coc|around